

NO ./textures/wall_north.xpm
SO ./textures/wall_south.xpm

WE ./textures/wall_west.xpm


EA ./textures/wall_east.xpm

F 100,100,100

C 135,206,235



111111111111111111111111111111111111111111111111111111111111111111111111111111111111111111111111111
1E0000100000000000000000000000000000000000000000000000000000000010000000000000000000000000000000001
100000000000000000000000000000001000000000000000110000000000000000000000000000000000000000000000001
100000000000000000000000000000000000000000000000000000000000000000000000000000000000000000000000001
100000010000000000000000000000000010110000000000000000000000000000000000000000000000000000000000001
100000000000000000000000000000000000000000000000000010000000000000000000000000000000000000000000001
100000000000000000000000000000000000000000000000000000000000010000000000000000000000000000000000001
100000000000000000000000000010000000000000000000000000000000000000000000000000000000000000000000001
100000000000000000000000000000000000000000000000000010000000000000000000100000000010000000000000001
100000000000000000000000001000000000000010000000000000000000000000000000000100000000000000000000001
100000000100000000000000000000000000000000000001000000100000000000000000000000100000000000000000001
100000000000000000000000000000000000000000000000000000000000000000000000000000000000000000000000001
100000011000000000000000000000000000000000000000000000000000000000000000000001000000000000000000001
100010000000000000110000000000000000000000000010000000000000000000000000000000000100000000000000001
100000000000000000100000000000000001000000000000000000000000000000000000100000000000000000000000001
100000000000000000000000000000000000000000000000000000000000000000000000000000100000000000000000001
100000000000000000000000010000000000000000000000000000001100000000000000000000000000000000000000001
100000001100000000000000000000000000000000000000000000000000000000000000000000000000000000000000001
100000000000000000000000000000000000000000000000000000000000000000000000000000000000000000000000001
100000000000000001111000000000000000000000000001000000000000000000000000110000000000110000000000001
111110000000000000000000100000000000000000000000000000000000000000001000000000000000000000000000001
100000000000000000000000000000000000000010000000000000000001000000000000000000000010000000000000001
100000000000000000000000000000000000000001000000000000000000000000000000000000000000000000000000001
100000000000000000000000000000000000000000000000000000000000000000000000000010000000000000000000001
100000000000000000000000000000000000001100000000000000000000000000000000000000000000000000000000001
100000000000000001100000100000100000000000000000000000000000000000000000000000000000100000000000001
100000000000000000000000000010000000000000000010000000000000000000010000000000000000000000000000001
100000000000000000000000000000000000000000000000000000000000000000000000000000000000000000000000001
100000000000000000000000000000000000001000000000000000000000000000000000000000000000000000000000001
100000000000000000000000000011000000000000000000000000000000000000000000001100000000000010000000001
100000000001000000000000000000000000000000000001000000000000000000000000000000000000000100000000001
100000000000000000000000001100000000000000000000000000000000000000000000000000000000000000000000001
100000000000000000000000000000000000000000000000000000000000000000000000000000000000000000000000001
100000000000000000000000000100000000000000000000000000000000000000000000000000000000000000000000001
100000000000000000000000000000000000000000000000000000110110000000000000000000000000000000000000001
100000000000000000000000000000000000000000000000000000000000000000000000000000000010000000000000001
100000000000000000000000000000000000000000001100000000000000000000000000000000000000000000000000001
100000001111100000000000000000000000000000000000000000000000000000000000000000000000000000000000001
100000000000000000000000000000000000000001000000000000000000000000000000000000000000000000000000001
100000000000000000000000000000000000000000000000000000000000000000000000000000000000000000000000001
100000000000000000000000000000000000000000000000000000000000000000000000000000000000000000000000001
100000000000000000000000000000000000000000000000000000000011100000000000000000000000000000000000001
100000000000000000000000000000000000000000000000000000000000000000000000000000010000000000000000001
100000000000000000100000000000000000000000000001000000011100000000000000000000000000000000000000001
100000000000000000000000000000000000000000000000000000000000000000000000000000000000000000000000001
100000000000000000000000000000000000000000000000000110000000000000000000000000000000000000000000001
100000000000000000000000000000000000000000000000000000000000000000000000000000000000000000000000001
100000000000000000000000000000000000000000000010000000000000000000000000000000000000000000000000001
100000000011100000000000000000001000000000000000000000000000000000000000000000000000000000000000001
100000000000000000000000000000000000000000000000000000000000000000111000000000000000000000000000001
100000000000000000000000000000000000000000000000000000000000000000000000000000000011010000000000001
100000000000000000000000000000000000000000000000000000000010000000000000001000000000000000000000001
100000000000000000000000000000000000100000000000000000000000000000000000000000000001000000000000001
100000000000000000000000000000000000000000000000000000000010000000000000000000000000000000000000001
100000000000000000000000000000000000000000000000000000000000000000000000000000000000000000000000001
100000000100000000000000000000000000000011000000000000000000100000000000000000000000000000000000001
100000000000000000000111000000000000000000000000000000000000000000000000000000000000000000000000001
100000000000000000000000000000000000010000000000000000000000000000010000000010000000000000000000001
100000000000000000000000000000000000000000000000000000000000000000000000000000000000000000000000001
100000000000000000000000000110000000000000000000010000000010000000000000000000000000000000000000001
100000000000000000000000000000000000000000000000000000000000000000000000000000000000000000000000001
100000000000000000000000000000000000000000000000000000000000100000000000000000100000000000000000001
100000000000000000000000000000000000000000000000000000000000000000000000000001000000000000000000001
100000000000000000000000000000000000000000100000000000000000000000000000000000000000000000000000001
100000000000000000000000000110000000000000000000000000000000000000000000000000000000000000000000001
100000000000000000000000000000000000001000000000000000000000000000000000000000000000000000000000001
100000000000000000000000000000000000000000000000000000000000000100000000000000000000000000000000001
100000000000000000000000000010000000000000000000000000000000000000000000000000000000000000000000001
100000000000000000000000000000000000000000000000000000000001110000000000000000000000000000000000001
100000000000000100000000000110000000000000000000000000000000000000000000000000000000000000000000001
100000000000011000000000000000000000000000000000000000000000000000000000000000000000000000000000001
100000000000000000000000000000000000000000000000000000000000000000000000000000000000000000000000001
100000000000000000000000000000000000000000000000000000000000000000000000000000000000000000000000001
100000000000000000000000000000000000000000000000011100000000000000000000000000000000000000000000001
100000000000000000000000000000000000000000000000000000000000000000000001100000000000000000000000001
100000000000000000000000000000000011100000000000000000000000000000000000000000010000000000000000001
100000000000000000000000000000000000000000000000000000000000000000000000000000000000000000000000001
100000000000000000000000000000000000000000000000000000000000000000000000000000000000000000000000001
100011100000000000000000000000000000000000000000000000000000000000100000000000000000000000000000001
100000000000000000000000000000000000000000000000000000011000000000000000001100000000000000000000001
100000000000000000000000000000000000000000000000000000000000000000000000000000000000000000000000001
100000000000000000000000000000000001000000000000000000000000000000000000000000000000000000000000001
100000000000000000000000000000000000000000000000000000110000000000000000000000000000000000000000001
100000000000000000000000000000000000000000000000000000000000000000000000000000000000000000000000001
111111111111111111111111111111111111111111111111111111111111111111111111111111111111111111111111111