NO ./textures/wall_north.xpm
SO ./textures/wall_south.xpm
WE ./textures/wall_west.xpm
EA ./textures/wall_east.xpm

F 100,100,100
C 135,206,235

11111111111111111111111111111111
10000001000100000000000000000001
10101101101001010000000000000001
10001000000011010000000000000001
10100111110100010000000000000001
10110100001101010000000000000001
10101001100001010000000000000001
10100100011110010000000000000001
10001111101000110000000000000001
10110000101010010000000000000001
10101011101101110000000000000001
10101000001000010000000000000001
10001111101101000000000000000001
10111000000011010000000000000001
1N000010101000010000000000000001
11111111111111111111111111111111
