NO ./textures/wall_north.xpm
SO ./textures/wall_south.xpm
WE ./textures/wall_west.xpm
EA ./textures/wall_east.xpm

F 100,100,100
C 135,206,235

1111111111111111
1000000100010001
1010110110100101
1000100000001101
1010011111010001
1011010000110101
1010100110000101
1010010001111001
1000111110100011
1011000010101001
1010101110110111
1010100000100001
1000111110110101
1011100000001101
1N00001010100001
1111111111111111


